aaaaaaaa``
a##a##aa``
a#aa#aaa``
a#aa#aaa``
a####aaa``
aaaaaaaaaa
``aaaaaa``
```aa`````